11111111111111111111111111111111
1P000000000000000000000000000001
10000000000000000000000000000001
10000000000000000000000000000001
1000C00C00CCCC000C000C0000000001
1000C00C00C0000000C0C00000000001
1000CCCC00CCC000000C000000000001
1000C00C00C00000000C000000000001
1000C00C00CCCC00000C000000000001
10000000000000000000000000000001
1CCCCC00C00C00CCCC00CC0000CCCC01
100C0000C00C00C00000C0C000C00001
100C0000CCCC00CCC000CC0000CCC001
100C0000C00C00C00000C0C000C00001
100C0000C00C00CCCC00C00C00CCCC01
100000000000000000000000000000E1
11111111111111111111111111111111