11111111111111111111111111111111
10000000100000000010000C100000E1
10000000100000000010000010000001
1000000000Z0000000000000000Z0001
10000000C01000000010000000000001
10010000000C00010010000000000001
1P0100000Z0000000000000Z000C0001
11111111111111111111111111111111