11111111111111111111111111111111
1P0000C000000C0000Z000C0000000E1
11111111111111111111111111111111