11111111111111
1000P0000C00E11
11111111111111