111111111
1000P0111
100C001C1
100E00001
111111111