1111111
1Z000P1
1C01111
1000E11
1111111