1111111
1Z000P1
1C00000
1000E11
1111111